########
#AB#CYD#
#^##X#P#
#EVFZOG#
###U####
#HRISJK#
#L#M#Q##
#####N##